Abbeville	LA
Aberdeen	MD
Aberdeen	SD
Aberdeen	WA
Abilene	TX
Abington	MA
Acworth	GA
Ada	OK
Addison	IL
Addison	TX
Adelanto	CA
Adelphi	MD
Adrian	MI
Affton	MO
Agawam	MA
Agoura Hills	CA
Aiken	SC
Akron	OH
Alabaster	AL
Alameda	CA
Alamo	CA
Alamo	TX
Alamogordo	NM
Albany	CA
Albany	GA
Albany	NY
Albany	OR
Albemarle	NC
Albert Lea	MN
Albertville	AL
Albuquerque	NM
Alderwood Manor	WA
Aldine	TX
Alexander City	AL
Alexandria	LA
Alexandria	VA
Algonquin	IL
Alhambra	CA
Alice	TX
Aliquippa	PA
Aliso Viejo	CA
Allen	TX
Allen Park	MI
Allendale	MI
Allentown	PA
Alliance	OH
Allouez	WI
Aloha	OR
Alpena	MI
Alpharetta	GA
Alpine	CA
Alsip	IL
Altadena	CA
Altamont	OR
Altamonte Springs	FL
Alton	IL
Altoona	IA
Altoona	PA
Altus	OK
Alum Rock	CA
Alvin	TX
Amarillo	TX
American Fork	UT
Americus	GA
Ames	IA
Amesbury	MA
Amherst	OH
Amherst Center	MA
Amsterdam	NY
Anacortes	WA
Anaheim	CA
Anchorage	AK
Anderson	IN
Anderson	SC
Andover	MN
Angleton	TX
Ankeny	IA
Ann Arbor	MI
Annandale	VA
Annapolis	MD
Anniston	AL
Anoka	MN
Ansonia	CT
Antioch	CA
Apache Junction	AZ
Apex	NC
Apopka	FL
Apple Valley	CA
Apple Valley	MN
Appleton	WI
Arbutus	MD
Arcadia	CA
Arcata	CA
Arden-Arcade	CA
Ardmore	OK
Ardmore	PA
Arkadelphia	AR
Arkansas City	KS
Arlington	MA
Arlington	NY
Arlington	TX
Arlington	VA
Arlington	WA
Arlington Heights	IL
Arnold	MD
Arnold	MO
Arroyo Grande	CA
Artesia	CA
Artesia	NM
Arvada	CO
Arvin	CA
Asbury Park	NJ
Asheboro	NC
Asheville	NC
Ashland	CA
Ashland	KY
Ashland	OH
Ashland	OR
Ashtabula	OH
Ashwaubenon	WI
Aspen Hill	MD
Atascadero	CA
Atascocita	TX
Atchison	KS
Athens	AL
Athens	OH
Athens	TN
Athens	TX
Athens-Clarke County	GA
Atlanta	GA
Atlantic Beach	FL
Atlantic City	NJ
Attleboro	MA
Atwater	CA
Auburn	AL
Auburn	CA
Auburn	IN
Auburn	ME
Auburn	NY
Auburn	WA
Auburn Hills	MI
Auburndale	FL
Augusta	ME
Augusta-Richmond County	GA
Aurora	CO
Aurora	IL
Aurora	OH
Austin	MN
Austin	TX
Austintown	OH
Avenal	CA
Avenel	NJ
Aventura	FL
Avocado Heights	CA
Avon	OH
Avon Lake	OH
Avondale	AZ
Azalea Park	FL
Azusa	CA
Babylon	NY
Back Mountain	PA
Bailey's Crossroads	VA
Bainbridge	GA
Bainbridge Island	WA
Baker	LA
Bakersfield	CA
Balch Springs	TX
Baldwin	NY
Baldwin	PA
Baldwin Park	CA
Ballenger Creek	MD
Ballwin	MO
Baltimore	MD
Bangor	ME
Banning	CA
Baraboo	WI
Barberton	OH
Barclay-Kingston	NJ
Bardstown	KY
Barnstable Town	MA
Barrington	IL
Barrington	RI
Barstow	CA
Bartlesville	OK
Bartlett	IL
Bartlett	TN
Bartow	FL
Bastrop	LA
Batavia	IL
Batavia	NY
Baton Rouge	LA
Battle Creek	MI
Bay City	MI
Bay City	TX
Bay Point	CA
Bay Shore	NY
Bay Village	OH
Bayonet Point	FL
Bayonne	NJ
Bayou Cane	LA
Bayshore Gardens	FL
Baytown	TX
Baywood-Los Osos	CA
Beach Park	IL
Beachwood	NJ
Beachwood	OH
Beacon	NY
Bear	DE
Beatrice	NE
Beaufort	SC
Beaumont	CA
Beaumont	TX
Beaver Dam	WI
Beavercreek	OH
Beaverton	OR
Beckley	WV
Bedford	IN
Bedford	OH
Bedford	TX
Bedford Heights	OH
Beech Grove	IN
Beecher	MI
Beeville	TX
Bel Air	MD
Bel Air North	MD
Bel Air South	MD
Bell	CA
Bell Gardens	CA
Bella Vista	AR
Bellaire	TX
Bellair-Meadowbrook Terrace	FL
Belle Glade	FL
Bellefontaine	OH
Bellefontaine Neighbors	MO
Belleville	IL
Belleville	NJ
Bellevue	NE
Bellevue	WA
Bellevue Town	WI
Bellflower	CA
Bellingham	WA
Bellmawr	NJ
Bellmore	NY
Bellview	FL
Bellwood	IL
Belmont	CA
Belmont	MA
Beloit	WI
Belton	MO
Belton	TX
Beltsville	MD
Belvedere Park	GA
Belvidere	IL
Bemidji	MN
Benbrook	TX
Bend	OR
Benicia	CA
Bensenville	IL
Benton	AR
Benton Harbor	MI
Bentonville	AR
Berea	OH
Berea	SC
Bergenfield	NJ
Berkeley	CA
Berkeley	MO
Berkeley Heights	NJ
Berkley	CO
Berkley	MI
Berlin	NH
Berwick	PA
Berwyn	IL
Bessemer	AL
Bethany	OK
Bethel Park	PA
Bethesda	MD
Bethlehem	PA
Bethpage	NY
Bettendorf	IA
Beverly	MA
Beverly Hills	CA
Beverly Hills	MI
Bexley	OH
Biddeford	ME
Big Rapids	MI
Big Spring	TX
Billings	MT
Biloxi	MS
Binghamton	NY
Birmingham	AL
Birmingham	MI
Bismarck	ND
Bixby	OK
Black Forest	CO
Blackfoot	ID
Blackhawk-Camino Tassajara	CA
Blacksburg	VA
Blaine	MN
Bloomfield	NJ
Bloomfield Township	MI
Bloomingdale	FL
Bloomingdale	IL
Bloomingdale	TN
Bloomington	CA
Bloomington	IL
Bloomington	IN
Bloomington	MN
Bloomsburg	PA
Blue Ash	OH
Blue Island	IL
Blue Springs	MO
Bluefield	WV
Blythe	CA
Blytheville	AR
Boardman	OH
Boca Del Mar	FL
Boca Raton	FL
Bogalusa	LA
Boise City	ID
Bolingbrook	IL
Bon Air	VA
Bonita	CA
Bonita Springs	FL
Boone	IA
Boone	NC
Borger	TX
Bossier City	LA
Boston	MA
Bostonia	CA
Bothell	WA
Boulder	CO
Boulder City	NV
Bound Brook	NJ
Bountiful	UT
Bourbonnais	IL
Bowie	MD
Bowling Green	KY
Bowling Green	OH
Boynton Beach	FL
Bozeman	MT
Bradenton	FL
Bradley	IL
Brainerd	MN
Braintree	MA
Brandon	FL
Brandon	MS
Brawley	CA
Brea	CA
Brecksville	OH
Bremerton	WA
Brenham	TX
Brent	FL
Brentwood	CA
Brentwood	NY
Brentwood	PA
Brentwood	TN
Bridgeport	CT
Bridgeton	MO
Bridgeton	NJ
Bridgetown North	OH
Bridgeview	IL
Brigantine	NJ
Brigham City	UT
Brighton	CO
Brighton	NY
Bristol	CT
Bristol	RI
Bristol	TN
Bristol	VA
Broadview Heights	OH
Brockton	MA
Broken Arrow	OK
Brook Park	OH
Brookfield	IL
Brookfield	WI
Brookings	SD
Brookline	MA
Brooklyn	OH
Brooklyn Center	MN
Brooklyn Park	MD
Brooklyn Park	MN
Brookside	DE
Broomall	PA
Broomfield	CO
Brown Deer	WI
Browns Mills	NJ
Brownsburg	IN
Brownsville	FL
Brownsville	TN
Brownsville	TX
Brownwood	TX
Brunswick	GA
Brunswick	ME
Brunswick	OH
Brushy Creek	TX
Bryan	TX
Bryn Mawr-Skyway	WA
Bucyrus	OH
Buena Park	CA
Buffalo	MN
Buffalo	NY
Buffalo Grove	IL
Buford	GA
Bull Run	VA
Bullhead City	AZ
Burbank	CA
Burbank	IL
Burien	WA
Burkburnett	TX
Burke	VA
Burleson	TX
Burlingame	CA
Burlington	IA
Burlington	KY
Burlington	MA
Burlington	NC
Burlington	VT
Burnsville	MN
Burr Ridge	IL
Burton	MI
Butler	PA
Butte-Silver Bow County	MT
Cabot	AR
Cadillac	MI
Cahokia	IL
Calabasas	CA
Caldwell	ID
Calexico	CA
Calhoun	GA
Callaway	FL
Calumet City	IL
Calverton	MD
Camano	WA
Camarillo	CA
Camas	WA
Cambridge	MA
Cambridge	MD
Cambridge	OH
Camden	AR
Camden	NJ
Cameron Park	CA
Camp Springs	MD
Campbell	CA
Campbellsville	KY
Canandaigua	NY
Canby	OR
Candler-McAfee	GA
Canon City	CO
Canton	IL
Canton	MI
Canton	MS
Canton	OH
Canyon	TX
Canyon Lake	TX
Canyon Rim	UT
Cape Coral	FL
Cape Girardeau	MO
Capitola	CA
Carbondale	IL
Carlisle	PA
Carlsbad	CA
Carlsbad	NM
Carmel	IN
Carmichael	CA
Carney	MD
Carnot-Moon	PA
Carol City	FL
Carol Stream	IL
Carpentersville	IL
Carpinteria	CA
Carrboro	NC
Carroll	IA
Carrollton	GA
Carrollton	TX
Carson	CA
Carson	NV
Carteret	NJ
Cartersville	GA
Carthage	MO
Cary	IL
Cary	NC
Casa de Oro-Mount Helix	CA
Casa Grande	AZ
Casas Adobes	AZ
Cascade-Fairwood	WA
Casper	WY
Casselberry	FL
Castle Rock	CO
Castlewood	CO
Castro Valley	CA
Catalina Foothills	AZ
Cathedral City	CA
Catonsville	MD
Cave Spring	VA
Cayce	SC
Cedar City	UT
Cedar Falls	IA
Cedar Grove	NJ
Cedar Hill	TX
Cedar Mill	OR
Cedar Park	TX
Cedar Rapids	IA
Cedarburg	WI
Celina	OH
Center Point	AL
Centereach	NY
Centerville	OH
Centerville	UT
Central Falls	RI
Central Islip	NY
Central Manchester	CT
Central Point	OR
Centralia	IL
Centralia	WA
Centreville	VA
Ceres	CA
Cerritos	CA
Chalco	NE
Chalmette	LA
Chambersburg	PA
Champaign	IL
Champlin	MN
Chandler	AZ
Chanhassen	MN
Channelview	TX
Chantilly	VA
Chapel Hill	NC
Charleston	IL
Charleston	SC
Charleston	WV
Charlotte	NC
Charlottesville	VA
Chaska	MN
Chattanooga	TN
Cheektowaga	NY
Chelsea	MA
Cherry Hill Mall	NJ
Cherryland	CA
Chesapeake	VA
Chesapeake Ranch Estates-Drum Point	MD
Chester	PA
Chester	VA
Chesterfield	MO
Chesterton	IN
Cheyenne	WY
Chicago	IL
Chicago Heights	IL
Chicago Ridge	IL
Chickasha	OK
Chico	CA
Chicopee	MA
Chillicothe	OH
Chillum	MD
Chino	CA
Chino Hills	CA
Chippewa Falls	WI
Chowchilla	CA
Christiansburg	VA
Chula Vista	CA
Cicero	IL
Cimarron Hills	CO
Cincinnati	OH
Cinco Ranch	TX
Circleville	OH
Citrus	CA
Citrus Heights	CA
Citrus Park	FL
Citrus Ridge	FL
City of The Dalles	OR
Claremont	CA
Claremont	NH
Claremore	OK
Clark	NJ
Clarksburg	WV
Clarksdale	MS
Clarksville	IN
Clarksville	TN
Clawson	MI
Clayton	CA
Clayton	MO
Clayton	OH
Clearfield	UT
Clearlake	CA
Clearwater	FL
Cleburne	TX
Clemmons	NC
Clemson	SC
Cleveland	MS
Cleveland	OH
Cleveland	TN
Cleveland Heights	OH
Cliffside Park	NJ
Clifton	CO
Clifton	NJ
Clinton	IA
Clinton	MD
Clinton	MI
Clinton	MS
Clinton	UT
Clive	IA
Cloquet	MN
Cloverleaf	TX
Clovis	CA
Clovis	NM
Clute	TX
Coachella	CA
Coalinga	CA
Coatesville	PA
Cockeysville	MD
Cocoa	FL
Cocoa Beach	FL
Coconut Creek	FL
Coeur d'Alene	ID
Coffeyville	KS
Cohoes	NY
Coldwater	MI
Colesville	MD
College	AK
College Park	GA
College Park	MD
College Station	TX
Colleyville	TX
Collierville	TN
Collingswood	NJ
Collinsville	IL
Colonia	NJ
Colonial Heights	VA
Colonial Park	PA
Colorado Springs	CO
Colton	CA
Columbia	MD
Columbia	MO
Columbia	PA
Columbia	SC
Columbia	TN
Columbia Heights	MN
Columbine	CO
Columbus	GA
Columbus	IN
Columbus	MS
Columbus	NE
Columbus	OH
Commack	NY
Commerce	CA
Commerce City	CO
Compton	CA
Comstock Park	MI
Concord	CA
Concord	MO
Concord	NC
Concord	NH
Conneaut	OH
Connersville	IN
Conning Towers-Nautilus Park	CT
Conroe	TX
Converse	TX
Conway	AR
Conway	FL
Conway	SC
Conyers	GA
Cookeville	TN
Coon Rapids	MN
Cooper City	FL
Coos Bay	OR
Copiague	NY
Coppell	TX
Copperas Cove	TX
Coral Gables	FL
Coral Hills	MD
Coral Springs	FL
Coral Terrace	FL
Coralville	IA
Coram	NY
Corcoran	CA
Cordele	GA
Corinth	MS
Corinth	TX
Cornelius	NC
Corning	NY
Corona	CA
Coronado	CA
Corpus Christi	TX
Corsicana	TX
Cortland	NY
Corvallis	OR
Coshocton	OH
Costa Mesa	CA
Coto de Caza	CA
Cottage Grove	MN
Cottage Lake	WA
Cottonwood Heights	UT
Cottonwood West	UT
Cottonwood-Verde Village	AZ
Council Bluffs	IA
Country Club	FL
Country Club Hills	IL
Country Walk	FL
Covina	CA
Covington	GA
Covington	KY
Covington	WA
Cranford	NJ
Cranston	RI
Crawfordsville	IN
Crest Hill	IL
Crestline	CA
Crestview	FL
Crestwood	IL
Crestwood	MO
Creve Coeur	MO
Crofton	MD
Cross Lanes	WV
Crowley	LA
Crown Point	IN
Crystal	MN
Crystal Lake	IL
Cudahy	CA
Cudahy	WI
Cullman	AL
Culver City	CA
Cumberland	MD
Cupertino	CA
Cutler	FL
Cutler Ridge	FL
Cutlerville	MI
Cuyahoga Falls	OH
Cypress	CA
Cypress Lake	FL
Dale City	VA
Dallas	OR
Dallas	TX
Dalton	GA
Daly City	CA
Damascus	MD
Dana Point	CA
Danbury	CT
Dania Beach	FL
Danvers	MA
Danville	CA
Danville	IL
Danville	KY
Danville	VA
Daphne	AL
Darby	PA
Darien	CT
Darien	IL
Davenport	IA
Davie	FL
Davis	CA
Dayton	OH
Daytona Beach	FL
De Bary	FL
De Land	FL
De Pere	WI
Dearborn	MI
Dearborn Heights	MI
Decatur	AL
Decatur	GA
Decatur	IL
Dedham	MA
Deer Park	NY
Deer Park	TX
Deerfield	IL
Deerfield Beach	FL
Defiance	OH
DeKalb	IL
Del City	OK
Del Rio	TX
Delano	CA
Delaware	OH
Delray Beach	FL
Deltona	FL
Deming	NM
Denison	TX
Denton	TX
Dentsville	SC
Denver	CO
Depew	NY
Derby	CT
Derby	KS
Derry	NH
Des Moines	IA
Des Moines	WA
Des Plaines	IL
Desert Hot Springs	CA
DeSoto	TX
Destin	FL
Destrehan	LA
Detroit	MI
Diamond Bar	CA
Dickinson	ND
Dickinson	TX
Dickson	TN
Dinuba	CA
Dishman	WA
Dix Hills	NY
Dixon	CA
Dixon	IL
Dobbs Ferry	NY
Dodge City	KS
Dolton	IL
Donna	TX
Doral	FL
Dothan	AL
Douglas	AZ
Douglas	GA
Douglasville	GA
Dover	DE
Dover	NH
Dover	NJ
Dover	OH
Downers Grove	IL
Downey	CA
Draper	UT
Drexel Heights	AZ
Drexel Hill	PA
Druid Hills	GA
Duarte	CA
Dublin	CA
Dublin	GA
Dublin	OH
Dubuque	IA
Duluth	GA
Duluth	MN
Dumas	TX
Dumont	NJ
Duncan	OK
Duncanville	TX
Dundalk	MD
Dunedin	FL
Dunkirk	NY
Dunmore	PA
Dunwoody	GA
Durango	CO
Durant	OK
Durham	NC
Dyer	IN
Dyersburg	TN
Eagan	MN
Eagle	ID
Eagle Pass	TX
Easley	SC
East Bethel	MN
East Brainerd	TN
East Brunswick	NJ
East Chicago	IN
East Cleveland	OH
East Grand Rapids	MI
East Hartford	CT
East Haven	CT
East Hemet	CA
East Highland Park	VA
East Hill-Meridian	WA
East Islip	NY
East Lake	FL
East Lansing	MI
East Liverpool	OH
East Los Angeles	CA
East Massapequa	NY
East Meadow	NY
East Millcreek	UT
East Moline	IL
East Norriton	PA
East Northport	NY
East Orange	NJ
East Palo Alto	CA
East Patchogue	NY
East Peoria	IL
East Point	GA
East Providence	RI
East Renton Highlands	WA
East Ridge	TN
East Riverdale	MD
East Rockaway	NY
East San Gabriel	CA
East St. Louis	IL
East Wenatchee Bench	WA
Eastchester	NY
Easthampton	MA
Eastlake	OH
Easton	MD
Easton	PA
Eastpointe	MI
Eatontown	NJ
Eau Claire	WI
Echelon	NJ
Ecorse	MI
Eden	NC
Eden Prairie	MN
Edgewater	FL
Edgewood	MD
Edina	MN
Edinburg	TX
Edison	NJ
Edmond	OK
Edmonds	WA
Edwardsville	IL
Effingham	IL
Egypt Lake-Leto	FL
El Cajon	CA
El Campo	TX
El Centro	CA
El Cerrito	CA
El Dorado	AR
El Dorado	KS
El Dorado Hills	CA
El Monte	CA
El Paso	TX
El Paso de Robles (Paso Robles)	CA
El Reno	OK
El Segundo	CA
El Sobrante	CA
Eldersburg	MD
Elfers	FL
Elgin	IL
Elizabeth	NJ
Elizabeth City	NC
Elizabethton	TN
Elizabethtown	KY
Elizabethtown	PA
Elk City	OK
Elk Grove	CA
Elk Grove Village	IL
Elk Plain	WA
Elk River	MN
Elkhart	IN
Elko	NV
Elkridge	MD
Elkton	MD
Ellensburg	WA
Ellicott City	MD
Elmhurst	IL
Elmira	NY
Elmont	NY
Elmwood Park	IL
Elmwood Park	NJ
Eloy	AZ
Elwood	NY
Elyria	OH
Emmaus	PA
Emporia	KS
Encinitas	CA
Endicott	NY
Endwell	NY
Englewood	CO
Englewood	FL
Englewood	NJ
Englewood	OH
Enid	OK
Ennis	TX
Ensley	FL
Enterprise	AL
Enterprise	NV
Enumclaw	WA
Ephrata	PA
Erie	PA
Erlanger	KY
Escanaba	MI
Escondido	CA
Essex	MD
Estelle	LA
Euclid	OH
Eufaula	AL
Eugene	OR
Euless	TX
Eunice	LA
Eureka	CA
Eustis	FL
Evans	GA
Evanston	IL
Evanston	WY
Evansville	IN
Everett	MA
Everett	WA
Evergreen Park	IL
Ewa Beach	HI
Ewing	NJ
Excelsior Springs	MO
Fair Lawn	NJ
Fair Oaks	CA
Fairbanks	AK
Fairborn	OH
Fairfax	VA
Fairfield	AL
Fairfield	CA
Fairfield	OH
Fairhope	AL
Fairland	MD
Fairmont	MN
Fairmont	WV
Fairmount	NY
Fairview	NJ
Fairview Heights	IL
Fairview Park	OH
Fairview Shores	FL
Fall River	MA
Fallbrook	CA
Falls Church	VA
Fargo	ND
Faribault	MN
Farmers Branch	TX
Farmington	MI
Farmington	MN
Farmington	MO
Farmington	NM
Farmington	UT
Farmington Hills	MI
Farmingville	NY
Farragut	TN
Fayetteville	AR
Fayetteville	GA
Fayetteville	NC
Federal Heights	CO
Federal Way	WA
Fenton	MI
Fergus Falls	MN
Ferguson	MO
Fern Creek	KY
Fernandina Beach	FL
Ferndale	MD
Ferndale	MI
Fernway	PA
Ferry Pass	FL
Fillmore	CA
Findlay	OH
Finneytown	OH
Fishers	IN
Fitchburg	MA
Fitchburg	WI
Five Corners	WA
Flagstaff	AZ
Flint	MI
Floral Park	NY
Florence	AL
Florence	AZ
Florence	KY
Florence	SC
Florence-Graham	CA
Florida Ridge	FL
Florin	CA
Florissant	MO
Flower Mound	TX
Flowing Wells	AZ
Folsom	CA
Fond du Lac	WI
Fontana	CA
Foothill Farms	CA
Foothill Ranch	CA
Fords	NJ
Forest Acres	SC
Forest City	FL
Forest Grove	OR
Forest Hill	TX
Forest Hills	MI
Forest Park	GA
Forest Park	IL
Forest Park	OH
Forestdale	AL
Forestville	MD
Forestville	OH
Forrest City	AR
Fort Atkinson	WI
Fort Benning South	GA
Fort Bragg	NC
Fort Campbell North	KY
Fort Carson	CO
Fort Collins	CO
Fort Dodge	IA
Fort Drum	NY
Fort Hood	TX
Fort Hunt	VA
Fort Knox	KY
Fort Lauderdale	FL
Fort Lee	NJ
Fort Leonard Wood	MO
Fort Lewis	WA
Fort Madison	IA
Fort Morgan	CO
Fort Myers	FL
Fort Payne	AL
Fort Pierce	FL
Fort Polk South	LA
Fort Smith	AR
Fort Stewart	GA
Fort Thomas	KY
Fort Walton Beach	FL
Fort Washington	MD
Fort Wayne	IN
Fort Worth	TX
Fortuna	CA
Fortuna Foothills	AZ
Foster City	CA
Fostoria	OH
Fountain	CO
Fountain Hills	AZ
Fountain Valley	CA
Fountainbleau	FL
Four Corners	OR
Framingham	MA
Franconia	VA
Frankfort	IL
Frankfort	IN
Frankfort	KY
Franklin	IN
Franklin	MA
Franklin	OH
Franklin	TN
Franklin	WI
Franklin Lakes	NJ
Franklin Park	IL
Franklin Park	PA
Franklin Square	NY
Fraser	MI
Frederick	MD
Fredericksburg	VA
Fredonia	NY
Freehold	NJ
Freeport	IL
Freeport	NY
Freeport	TX
Fremont	CA
Fremont	NE
Fremont	OH
Fresno	CA
Fridley	MN
Friendly	MD
Friendswood	TX
Frisco	TX
Front Royal	VA
Fruit Cove	FL
Fruitville	FL
Fullerton	CA
Fullerton	PA
Fulton	MO
Fulton	NY
Gadsden	AL
Gaffney	SC
Gages Lake	IL
Gahanna	OH
Gainesville	FL
Gainesville	GA
Gainesville	TX
Gaithersburg	MD
Galena Park	TX
Galesburg	IL
Galion	OH
Gallatin	TN
Gallup	NM
Galt	CA
Galveston	TX
Gantt	SC
Garden City	GA
Garden City	ID
Garden City	KS
Garden City	MI
Garden City	NY
Garden Grove	CA
Gardena	CA
Gardendale	AL
Gardner	MA
Gardnerville Ranchos	NV
Garfield	NJ
Garfield Heights	OH
Garland	TX
Garner	NC
Gary	IN
Gastonia	NC
Gates-North Gates	NY
Gatesville	TX
Gautier	MS
Geneva	IL
Geneva	NY
Georgetown	GA
Georgetown	KY
Georgetown	TX
Germantown	MD
Germantown	TN
Germantown	WI
Gilbert	AZ
Gillette	WY
Gilroy	CA
Girard	OH
Gladeview	FL
Gladstone	MO
Gladstone	OR
Glasgow	DE
Glasgow	KY
Glassboro	NJ
Glen Allen	VA
Glen Avon	CA
Glen Burnie	MD
Glen Carbon	IL
Glen Cove	NY
Glen Ellyn	IL
Glen Rock	NJ
Glendale	AZ
Glendale	CA
Glendale	WI
Glendale Heights	IL
Glendora	CA
Glenn Dale	MD
Glens Falls	NY
Glenvar Heights	FL
Glenview	IL
Gloucester	MA
Gloucester City	NJ
Gloversville	NY
Godfrey	IL
Golden	CO
Golden Gate	FL
Golden Glades	FL
Golden Valley	MN
Goldenrod	FL
Goldsboro	NC
Goleta	CA
Gonzalez	FL
Goodings Grove	IL
Goodlettsville	TN
Goodyear	AZ
Goose Creek	SC
Goshen	IN
Grafton	WI
Graham	NC
Grand Forks	ND
Grand Haven	MI
Grand Island	NE
Grand Junction	CO
Grand Prairie	TX
Grand Rapids	MI
Grand Terrace	CA
Grandview	MO
Grandville	MI
Granger	IN
Granite Bay	CA
Granite City	IL
Grants Pass	OR
Grapevine	TX
Grass Valley	CA
Grayslake	IL
Great Bend	KS
Great Falls	MT
Greater Carrollwood	FL
Greater Landover	MD
Greater Northdale	FL
Greater Sun Center	FL
Greater Upper Marlboro	MD
Greece	NY
Greeley	CO
Green	OH
Green Bay	WI
Green Haven	MD
Green River	WY
Green Valley	AZ
Green Valley	MD
Greenacres	FL
Greenbelt	MD
Greendale	WI
Greeneville	TN
Greenfield	CA
Greenfield	IN
Greenfield	MA
Greenfield	WI
Greenlawn	NY
Greensboro	NC
Greensburg	IN
Greensburg	PA
Greentree	NJ
Greenville	MS
Greenville	NC
Greenville	OH
Greenville	SC
Greenville	TX
Greenwood	IN
Greenwood	MS
Greenwood	SC
Greenwood Village	CO
Greer	SC
Grenada	MS
Gresham	OR
Gretna	LA
Griffin	GA
Griffith	IN
Grosse Ile	MI
Grosse Pointe Park	MI
Grosse Pointe Woods	MI
Groton	CT
Grove City	OH
Grover Beach	CA
Groves	TX
Groveton	VA
Gulf Gate Estates	FL
Gulfport	FL
Gulfport	MS
Gurnee	IL
Guttenberg	NJ
Guymon	OK
Hacienda Heights	CA
Hackensack	NJ
Hackettstown	NJ
Haddonfield	NJ
Hagerstown	MD
Haines City	FL
Halawa	HI
Half Moon Bay	CA
Halfway	MD
Hallandale	FL
Haltom City	TX
Ham Lake	MN
Hamburg	NY
Hamilton	OH
Hammond	IN
Hammond	LA
Hammonton	NJ
Hampton	VA
Hampton Bays	NY
Hampton Township	PA
Hamptons at Boca Raton	FL
Hamtramck	MI
Hanahan	SC
Hanford	CA
Hannibal	MO
Hanover	PA
Hanover Park	IL
Harker Heights	TX
Harlingen	TX
Harper Woods	MI
Harrisburg	PA
Harrison	AR
Harrison	MI
Harrison	NJ
Harrison	NY
Harrison Township	PA
Harrisonburg	VA
Hartford	CT
Hartford	WI
Hartselle	AL
Harvey	IL
Harvey	LA
Hasbrouck Heights	NJ
Haslett	MI
Hastings	MN
Hastings	NE
Hattiesburg	MS
Hauppauge	NY
Havelock	NC
Haverhill	MA
Haverstraw	NY
Havre de Grace	MD
Hawaiian Gardens	CA
Hawthorne	CA
Hawthorne	NJ
Hayesville	OR
Hays	KS
Hayward	CA
Hazel Crest	IL
Hazel Park	MI
Hazelwood	MO
Hazleton	PA
Healdsburg	CA
Helena	AL
Helena	MT
Hemet	CA
Hempstead	NY
Henderson	KY
Henderson	NC
Henderson	NV
Henderson	TX
Hendersonville	NC
Hendersonville	TN
Hercules	CA
Hereford	TX
Hermiston	OR
Hermitage	PA
Hermosa Beach	CA
Herndon	VA
Herrin	IL
Hershey	PA
Hesperia	CA
Hewitt	TX
Hialeah	FL
Hialeah Gardens	FL
Hibbing	MN
Hickory	NC
Hickory Hills	IL
Hicksville	NY
High Point	NC
Highland	CA
Highland	IN
Highland Park	IL
Highland Park	MI
Highland Park	NJ
Highland Springs	VA
Highland Village	TX
Highlands Ranch	CO
Highview	KY
Hillcrest Heights	MD
Hilliard	OH
Hillsboro	OR
Hillsborough	CA
Hillsdale	NJ
Hillside	NJ
Hilo	HI
Hilton Head Island	SC
Hinesville	GA
Hinsdale	IL
Hobart	IN
Hobbs	NM
Hobe Sound	FL
Hoboken	NJ
Hockessin	DE
Hoffman Estates	IL
Holbrook	MA
Holbrook	NY
Holiday	FL
Holiday City-Berkeley	NJ
Holladay	UT
Holland	MI
Hollins	VA
Hollister	CA
Holly Hill	FL
Hollywood	FL
Holt	MI
Holtsville	NY
Holyoke	MA
Homestead	FL
Homewood	AL
Homewood	IL
Homosassa Springs	FL
Honolulu	HI
Hoover	AL
Hopatcong	NJ
Hope	AR
Hope Mills	NC
Hopewell	VA
Hopkins	MN
Hopkinsville	KY
Horn Lake	MS
Horsham	PA
Hot Springs	AR
Houma	LA
Houston	TX
Howard	WI
Huber Heights	OH
Hudson	FL
Hudson	MA
Hudson	OH
Hueytown	AL
Hull	MA
Humble	TX
Huntersville	NC
Huntington	IN
Huntington	NY
Huntington	WV
Huntington Beach	CA
Huntington Park	CA
Huntington Station	NY
Huntsville	AL
Huntsville	TX
Huron	SD
Hurst	TX
Hutchinson	KS
Hutchinson	MN
Hyattsville	MD
Hybla Valley	VA
Idaho Falls	ID
Idylwood	VA
Immokalee	FL
Imperial Beach	CA
Independence	KY
Independence	MO
Indian Trail	NC
Indiana	PA
Indianapolis	IN
Indianola	IA
Indianola	MS
Indio	CA
Inglewood	CA
Inglewood-Finn Hill	WA
Inkster	MI
Inver Grove Heights	MN
Iona	FL
Ionia	MI
Iowa City	IA
Irmo	SC
Irondequoit	NY
Ironton	OH
Irvine	CA
Irving	TX
Irvington	NJ
Iselin	NJ
Isla Vista	CA
Islip	NY
Issaquah	WA
Ithaca	NY
Ives Estates	FL
Jacinto City	TX
Jackson	MI
Jackson	MO
Jackson	MS
Jackson	TN
Jacksonville	AR
Jacksonville	FL
Jacksonville	IL
Jacksonville	NC
Jacksonville	TX
Jacksonville Beach	FL
Jamestown	ND
Jamestown	NY
Janesville	WI
Jasmine Estates	FL
Jasper	AL
Jasper	IN
Jeannette	PA
Jefferson	LA
Jefferson	VA
Jefferson City	MO
Jefferson Valley-Yorktown	NY
Jeffersontown	KY
Jeffersonville	IN
Jenison	MI
Jennings	LA
Jennings	MO
Jensen Beach	FL
Jericho	NY
Jersey City	NJ
Johnson City	NY
Johnson City	TN
Johnstown	PA
Joliet	IL
Jollyville	TX
Jonesboro	AR
Joplin	MO
Joppatowne	MD
Junction City	KS
Juneau	AK
Jupiter	FL
Justice	IL
Kahului	HI
Kailua	HI
Kalamazoo	MI
Kalispell	MT
Kaneohe	HI
Kaneohe Station	HI
Kankakee	IL
Kannapolis	NC
Kansas City	KS
Kansas City	MO
Katy	TX
Kaukauna	WI
Kaysville	UT
Keansburg	NJ
Kearney	NE
Kearns	UT
Kearny	NJ
Keene	NH
Keizer	OR
Keller	TX
Kelso	WA
Ken Caryl	CO
Kendale Lakes	FL
Kendall	FL
Kendall West	FL
Kenmore	NY
Kenmore	WA
Kenner	LA
Kennesaw	GA
Kennett	MO
Kennewick	WA
Kenosha	WI
Kent	OH
Kent	WA
Kentwood	MI
Keokuk	IA
Kernersville	NC
Kerrville	TX
Kettering	MD
Kettering	OH
Kewanee	IL
Key Biscayne	FL
Key Largo	FL
Key West	FL
Keystone	FL
Kihei	HI
Kilgore	TX
Killeen	TX
King City	CA
King of Prussia	PA
Kingman	AZ
Kings Park	NY
Kings Point	FL
Kingsgate	WA
Kingsland	GA
Kingsport	TN
Kingston	NY
Kingston	PA
Kingsville	TX
Kinston	NC
Kirkland	WA
Kirksville	MO
Kirkwood	MO
Kiryas Joel	NY
Kissimmee	FL
Klamath Falls	OR
Knoxville	TN
Kokomo	IN
La Canada Flintridge	CA
La Crescenta-Montrose	CA
La Crosse	WI
La Grande	OR
La Grange	IL
La Grange Park	IL
La Habra	CA
La Homa	TX
La Marque	TX
La Mesa	CA
La Mirada	CA
La Palma	CA
La Porte	IN
La Porte	TX
La Presa	CA
La Puente	CA
La Quinta	CA
La Riviera	CA
La Vergne	TN
La Verne	CA
La Vista	NE
Lacey	WA
Lackawanna	NY
Laconia	NH
Ladson	SC
Lady Lake	FL
Lafayette	CA
Lafayette	CO
Lafayette	IN
Lafayette	LA
LaGrange	GA
Laguna	CA
Laguna Beach	CA
Laguna Hills	CA
Laguna Niguel	CA
Laguna Woods	CA
Lake Charles	LA
Lake Elsinore	CA
Lake Forest	CA
Lake Forest	IL
Lake Forest Park	WA
Lake Grove	NY
Lake Havasu City	AZ
Lake in the Hills	IL
Lake Jackson	TX
Lake Los Angeles	CA
Lake Magdalene	FL
Lake Mary	FL
Lake Oswego	OR
Lake Ridge	VA
Lake Ronkonkoma	NY
Lake Shore	MD
Lake St. Louis	MO
Lake Station	IN
Lake Wales	FL
Lake Worth	FL
Lake Worth Corridor	FL
Lake Zurich	IL
Lakeland	FL
Lakeland Highlands	FL
Lakeland North	WA
Lakeland South	WA
Lakeside	CA
Lakeside	FL
Lakeside	VA
Lakeville	MN
Lakewood	CA
Lakewood	CO
Lakewood	NJ
Lakewood	OH
Lakewood	WA
Lakewood Park	FL
Lamont	CA
Lancaster	CA
Lancaster	NY
Lancaster	OH
Lancaster	PA
Lancaster	TX
Land O' Lakes	FL
Landen	OH
Langley Park	MD
Lanham-Seabrook	MD
Lansdale	PA
Lansdowne	PA
Lansdowne-Baltimore Highlands	MD
Lansing	IL
Lansing	MI
Laplace	LA
Laramie	WY
Laredo	TX
Largo	FL
Larkspur	CA
Las Cruces	NM
Las Vegas	NM
Las Vegas	NV
Lathrop	CA
Lauderdale Lakes	FL
Lauderhill	FL
Laurel	MD
Laurel	MS
Laurel	VA
Laurinburg	NC
Lawndale	CA
Lawrence	IN
Lawrence	KS
Lawrence	MA
Lawrenceburg	TN
Lawrenceville	GA
Lawton	OK
Layton	UT
Lea Hill	WA
League City	TX
Leavenworth	KS
Leawood	KS
Lebanon	IN
Lebanon	MO
Lebanon	NH
Lebanon	OH
Lebanon	OR
Lebanon	PA
Lebanon	TN
Leeds	AL
Lee's Summit	MO
Leesburg	FL
Leesburg	VA
Lehi	UT
Lehigh Acres	FL
Leisure City	FL
Leisure Village West-Pine Lake Park	NJ
Lemay	MO
Lemon Grove	CA
Lemont	IL
Lemoore	CA
Lenexa	KS
Lennox	CA
Lenoir	NC
Leominster	MA
Levelland	TX
Levittown	NY
Levittown	PA
Lewisburg	TN
Lewiston	ID
Lewiston	ME
Lewisville	TX
Lexington	MA
Lexington	NC
Lexington	NE
Lexington Park	MD
Lexington-Fayette County	KY
Liberal	KS
Liberty	MO
Libertyville	IL
Lighthouse Point	FL
Lilburn	GA
Lima	OH
Lincoln	CA
Lincoln	IL
Lincoln	NE
Lincoln Park	MI
Lincoln Park	NJ
Lincolnia	VA
Lincolnwood	IL
Linda	CA
Linden	NJ
Lindenhurst	IL
Lindenhurst	NY
Lindenwold	NJ
Lindsay	CA
Linganore-Bartonsville	MD
Lino Lakes	MN
Lisle	IL
Little Chute	WI
Little Falls	NJ
Little Ferry	NJ
Little Rock	AR
Littleton	CO
Live Oak	CA
Livermore	CA
Livingston	CA
Livingston	NJ
Livonia	MI
Lochearn	MD
Lockhart	FL
Lockhart	TX
Lockport	IL
Lockport	NY
Lodi	CA
Lodi	NJ
Logan	UT
Logansport	IN
Loma Linda	CA
Lombard	IL
Lomita	CA
Lompoc	CA
Londonderry	NH
Long Beach	CA
Long Beach	MS
Long Beach	NY
Long Branch	NJ
Longmeadow	MA
Longmont	CO
Longview	TX
Longview	WA
Longwood	FL
Lorain	OH
Lorton	VA
Los Alamitos	CA
Los Alamos	NM
Los Altos	CA
Los Angeles	CA
Los Banos	CA
Los Gatos	CA
Los Lunas	NM
Louisville	CO
Louisville	KY
Loveland	CO
Loveland	OH
Loves Park	IL
Lowell	MA
Lower Burrell	PA
Lubbock	TX
Lufkin	TX
Luling	LA
Lumberton	NC
Lutherville-Timonium	MD
Lutz	FL
Lynbrook	NY
Lynchburg	VA
Lyndhurst	NJ
Lyndhurst	OH
Lynn	MA
Lynn Haven	FL
Lynnfield	MA
Lynnwood	WA
Lynwood	CA
Lyons	IL
Mableton	GA
Machesney Park	IL
Macomb	IL
Macon	GA
Madera	CA
Madison	AL
Madison	IN
Madison	MS
Madison	NJ
Madison	WI
Madison Heights	MI
Madison Heights	VA
Madisonville	KY
Magalia	CA
Magna	UT
Magnolia	AR
Maitland	FL
Makakilo City	HI
Malden	MA
Malibu	CA
Mamaroneck	NY
Manassas	VA
Manassas Park	VA
Manchester	MO
Manchester	NH
Mandan	ND
Mandeville	LA
Manhattan	KS
Manhattan Beach	CA
Manitowoc	WI
Mankato	MN
Manorville	NY
Mansfield	OH
Mansfield	TX
Manteca	CA
Manville	NJ
Maple Grove	MN
Maple Heights	OH
Maple Valley	WA
Maplewood	MN
Maplewood	NJ
Marana	AZ
Marathon	FL
Marblehead	MA
Marco Island	FL
Margate	FL
Marietta	GA
Marietta	OH
Marina	CA
Marinette	WI
Marion	IA
Marion	IL
Marion	IN
Marion	OH
Markham	IL
Marlborough	MA
Marlton	NJ
Marquette	MI
Marrero	LA
Marshall	MN
Marshall	MO
Marshall	TX
Marshalltown	IA
Marshfield	WI
Martha Lake	WA
Martin	TN
Martinez	CA
Martinez	GA
Martinsburg	WV
Martinsville	IN
Martinsville	VA
Maryland Heights	MO
Marysville	CA
Marysville	OH
Marysville	WA
Maryville	MO
Maryville	TN
Mason	OH
Mason City	IA
Masonboro	NC
Massapequa	NY
Massapequa Park	NY
Massena	NY
Massillon	OH
Mastic	NY
Mastic Beach	NY
Matteson	IL
Matthews	NC
Mattoon	IL
Mauldin	SC
Maumee	OH
Maumelle	AR
Mayfield	KY
Mayfield Heights	OH
Maynard	MA
Mays Chapel	MD
Maywood	CA
Maywood	IL
McAlester	OK
McAllen	TX
McCandless Township	PA
McComb	MS
McHenry	IL
McKeesport	PA
McKinleyville	CA
McKinney	TX
McLean	VA
McMinnville	OR
McMinnville	TN
McPherson	KS
Meadow Woods	FL
Meadville	PA
Mechanicsville	VA
Medford	MA
Medford	NY
Medford	OR
Medina	OH
Mehlville	MO
Melbourne	FL
Melrose	MA
Melrose Park	IL
Melville	NY
Melvindale	MI
Memphis	TN
Menasha	WI
Mendota Heights	MN
Menlo Park	CA
Menomonee Falls	WI
Menomonie	WI
Mentor	OH
Mequon	WI
Meraux	LA
Merced	CA
Mercedes	TX
Mercer Island	WA
Mercerville-Hamilton Square	NJ
Meriden	CT
Meridian	ID
Meridian	MS
Merriam	KS
Merrick	NY
Merrifield	VA
Merrill	WI
Merrillville	IN
Merritt Island	FL
Merrydale	LA
Mesa	AZ
Mesquite	TX
Metairie	LA
Methuen	MA
Metuchen	NJ
Mexico	MO
Miami	FL
Miami	OK
Miami Beach	FL
Miami Lakes	FL
Miami Shores	FL
Miami Springs	FL
Miamisburg	OH
Michigan City	IN
Middle River	MD
Middle Valley	TN
Middleburg	FL
Middleburg Heights	OH
Middlesborough	KY
Middlesex	NJ
Middleton	WI
Middletown	CT
Middletown	NY
Middletown	OH
Midland	MI
Midland	TX
Midlothian	IL
Midvale	UT
Midwest City	OK
Milford	CT
Milford	MA
Milford Mill	MD
Mililani Town	HI
Mill Creek	WA
Mill Valley	CA
Millbrae	CA
Millbrook	AL
Millburn	NJ
Millcreek	UT
Milledgeville	GA
Miller Place	NY
Millington	TN
Millville	NJ
Milpitas	CA
Milton	MA
Milwaukee	WI
Milwaukie	OR
Minden	LA
Mineola	NY
Mineral Wells	TX
Minneapolis	MN
Minnetonka	MN
Minot	ND
Mint Hill	NC
Mira Loma	CA
Miramar	FL
Mishawaka	IN
Mission	TX
Mission Bend	TX
Mission Viejo	CA
Missoula	MT
Missouri City	TX
Mitchell	SD
Moberly	MO
Mobile	AL
Modesto	CA
Mohave Valley	AZ
Mokena	IL
Moline	IL
Monroe	GA
Monroe	LA
Monroe	MI
Monroe	NC
Monroe	WA
Monroe	WI
Monrovia	CA
Monsey	NY
Montclair	CA
Montclair	NJ
Montclair	VA
Montebello	CA
Montecito	CA
Monterey	CA
Monterey Park	CA
Montgomery	AL
Montgomery	OH
Montgomery Village	MD
Montgomeryville	PA
Montpelier	VT
Montrose	CO
Moore	OK
Moorestown-Lenola	NJ
Mooresville	NC
Moorhead	MN
Moorpark	CA
Moraga	CA
Moreno Valley	CA
Morgan City	LA
Morgan Hill	CA
Morganton	NC
Morgantown	WV
Morganville	NJ
Morris	IL
Morristown	NJ
Morristown	TN
Morrisville	PA
Morro Bay	CA
Morton	IL
Morton Grove	IL
Moscow	ID
Moses Lake	WA
Moss Bluff	LA
Moss Point	MS
Moultrie	GA
Mounds View	MN
Mount Clemens	MI
Mount Juliet	TN
Mount Lebanon	PA
Mount Pleasant	MI
Mount Pleasant	SC
Mount Pleasant	TX
Mount Prospect	IL
Mount Vernon	IL
Mount Vernon	NY
Mount Vernon	OH
Mount Vernon	VA
Mount Vernon	WA
Mountain Brook	AL
Mountain Home	AR
Mountain Home	ID
Mountain Park	GA
Mountain Top	PA
Mountain View	CA
Mountlake Terrace	WA
Mukilteo	WA
Muncie	IN
Mundelein	IL
Munhall	PA
Municipality of Monroeville	PA
Municipality of Murrysville	PA
Munster	IN
Murfreesboro	TN
Murphysboro	IL
Murray	KY
Murray	UT
Murrieta	CA
Muscatine	IA
Muscle Shoals	AL
Muskego	WI
Muskegon	MI
Muskegon Heights	MI
Muskogee	OK
Mustang	OK
Myrtle Beach	SC
Myrtle Grove	FL
Nacogdoches	TX
Nampa	ID
Nanakuli	HI
Nanticoke	PA
Nanuet	NY
Napa	CA
Naperville	IL
Naples	FL
Nashua	NH
Nashville-Davidson County	TN
Natchez	MS
Natchitoches	LA
National City	CA
Naugatuck	CT
Nederland	TX
Needham	MA
Neenah	WI
Neosho	MO
Nesconset	NY
Nether Providence Township	PA
New Albany	IN
New Bedford	MA
New Berlin	WI
New Bern	NC
New Braunfels	TX
New Brighton	MN
New Britain	CT
New Brunswick	NJ
New Carrollton	MD
New Cassel	NY
New Castle	IN
New Castle	PA
New City	NY
New Haven	CT
New Haven	IN
New Hope	MN
New Iberia	LA
New Kensington	PA
New Kingman-Butler	AZ
New Lenox	IL
New London	CT
New Milford	NJ
New Orleans	LA
New Philadelphia	OH
New Port Richey	FL
New Providence	NJ
New River	AZ
New Rochelle	NY
New Smyrna Beach	FL
New Territory	TX
New Ulm	MN
New York	NY
Newark	CA
Newark	DE
Newark	NJ
Newark	OH
Newberg	OR
Newberry	SC
Newburg	KY
Newburgh	NY
Newburyport	MA
Newington	CT
Newington	VA
Newnan	GA
Newport	KY
Newport	RI
Newport Beach	CA
Newport East	RI
Newport News	VA
Newton	IA
Newton	KS
Newton	MA
Newton	NC
Niagara Falls	NY
Niceville	FL
Nicholasville	KY
Niles	IL
Niles	MI
Niles	OH
Nipomo	CA
Nixa	MO
Noblesville	IN
Nogales	AZ
Norco	CA
Norfolk	NE
Norfolk	VA
Norland	FL
Normal	IL
Norman	OK
Norridge	IL
Norristown	PA
North Adams	MA
North Amityville	NY
North Arlington	NJ
North Atlanta	GA
North Attleborough Center	MA
North Auburn	CA
North Augusta	SC
North Aurora	IL
North Babylon	NY
North Bay Shore	NY
North Bellmore	NY
North Bethesda	MD
North Brunswick Township	NJ
North Canton	OH
North Charleston	SC
North Chicago	IL
North College Hill	OH
North Creek	WA
North Decatur	GA
North Druid Hills	GA
North Fair Oaks	CA
North Fort Myers	FL
North Haven	CT
North Highlands	CA
North Las Vegas	NV
North Lauderdale	FL
North Laurel	MD
North Lindenhurst	NY
North Little Rock	AR
North Mankato	MN
North Marysville	WA
North Massapequa	NY
North Merrick	NY
North Miami	FL
North Miami Beach	FL
North Myrtle Beach	SC
North New Hyde Park	NY
North Ogden	UT
North Olmsted	OH
North Palm Beach	FL
North Plainfield	NJ
North Platte	NE
North Port	FL
North Potomac	MD
North Providence	RI
North Richland Hills	TX
North Ridgeville	OH
North Royalton	OH
North St. Paul	MN
North Tonawanda	NY
North Valley	NM
North Valley Stream	NY
North Versailles	PA
North Wantagh	NY
Northampton	MA
Northbrook	IL
Northbrook	OH
Northfield	MN
Northglenn	CO
Northlake	IL
Northport	AL
Northview	MI
Norton	OH
Norton Shores	MI
Norwalk	CA
Norwalk	CT
Norwalk	OH
Norwich	CT
Norwood	MA
Norwood	OH
Novato	CA
Novi	MI
Nutley	NJ
Oak Creek	WI
Oak Forest	IL
Oak Grove	OR
Oak Harbor	WA
Oak Lawn	IL
Oak Park	IL
Oak Park	MI
Oak Ridge	FL
Oak Ridge	TN
Oakdale	CA
Oakdale	MN
Oakland	CA
Oakland	NJ
Oakland Park	FL
Oakley	CA
Oakton	VA
Oakville	MO
Oatfield	OR
Ocala	FL
Ocean Acres	NJ
Ocean City	NJ
Ocean Pines	MD
Ocean Springs	MS
Oceanside	CA
Oceanside	NY
Ocoee	FL
Oconomowoc	WI
Odenton	MD
Odessa	TX
O'Fallon	IL
O'Fallon	MO
Ogden	UT
Ogdensburg	NY
Oil City	PA
Oildale	CA
Ojus	FL
Okemos	MI
Oklahoma City	OK
Okmulgee	OK
Okolona	KY
Olathe	KS
Old Bridge	NJ
Oldsmar	FL
Olean	NY
Olive Branch	MS
Olivehurst	CA
Olney	MD
Olympia	WA
Olympia Heights	FL
Omaha	NE
Onalaska	WI
Oneida	NY
Oneonta	NY
Ontario	CA
Ontario	OR
Opa-locka	FL
Opelika	AL
Opelousas	LA
Opportunity	WA
Oquirrh	UT
Orange	CA
Orange	CT
Orange	NJ
Orange	TX
Orangeburg	SC
Orangevale	CA
Orchards	WA
Orcutt	CA
Oregon	OH
Oregon City	OR
Orem	UT
Orinda	CA
Orland Park	IL
Orlando	FL
Ormond Beach	FL
Oro Valley	AZ
Oroville	CA
Oshkosh	WI
Oskaloosa	IA
Ossining	NY
Oswego	IL
Oswego	NY
Ottawa	IL
Ottawa	KS
Ottumwa	IA
Overland	MO
Overland Park	KS
Overlea	MD
Oviedo	FL
Owasso	OK
Owatonna	MN
Owensboro	KY
Owings Mills	MD
Owosso	MI
Oxford	AL
Oxford	MS
Oxford	OH
Oxnard	CA
Oxon Hill-Glassmanor	MD
Ozark	AL
Pacific Grove	CA
Pacifica	CA
Paducah	KY
Pahrump	NV
Paine Field-Lake Stickney	WA
Painesville	OH
Palatine	IL
Palatka	FL
Palestine	TX
Palisades Park	NJ
Palm Bay	FL
Palm Beach	FL
Palm Beach Gardens	FL
Palm City	FL
Palm Coast	FL
Palm Desert	CA
Palm Harbor	FL
Palm River-Clair Mel	FL
Palm Springs	CA
Palm Springs	FL
Palm Valley	FL
Palmdale	CA
Palmetto	FL
Palmetto Estates	FL
Palo Alto	CA
Palos Heights	IL
Palos Hills	IL
Palos Verdes Estates	CA
Pampa	TX
Panama City	FL
Panthersville	GA
Papillion	NE
Paradise	CA
Paradise	NV
Paradise Valley	AZ
Paragould	AR
Paramount	CA
Paramus	NJ
Paris	TX
Park Forest	IL
Park Ridge	IL
Parker	CO
Parker	SC
Parkersburg	WV
Parkland	FL
Parkland	WA
Parkville	MD
Parkway-South Sacramento	CA
Parlier	CA
Parma	OH
Parma Heights	OH
Parole	MD
Parsons	KS
Pasadena	CA
Pasadena	MD
Pasadena	TX
Pascagoula	MS
Pasco	WA
Passaic	NJ
Pataskala	OH
Patchogue	NY
Paterson	NJ
Patterson	CA
Pawtucket	RI
Payson	AZ
Payson	UT
Peabody	MA
Peachtree City	GA
Pearl	MS
Pearl City	HI
Pearl River	NY
Pearland	TX
Pecan Grove	TX
Pedley	CA
Peekskill	NY
Pekin	IL
Pelham	AL
Pembroke Pines	FL
Pendleton	OR
Penn Hills	PA
Pennsauken	NJ
Pennsville	NJ
Pensacola	FL
Peoria	AZ
Peoria	IL
Perris	CA
Perry Hall	MD
Perrysburg	OH
Perth Amboy	NJ
Peru	IN
Petaluma	CA
Petersburg	VA
Pewaukee	WI
Pflugerville	TX
Pharr	TX
Phenix City	AL
Philadelphia	PA
Phillipsburg	NJ
Phoenix	AZ
Phoenixville	PA
Picayune	MS
Picnic Point-North Lynnwood	WA
Pico Rivera	CA
Piedmont	CA
Pierre	SD
Pike Creek	DE
Pikesville	MD
Pine Bluff	AR
Pine Hill	NJ
Pine Hills	FL
Pinecrest	FL
Pinellas Park	FL
Pineville	LA
Pinewood	FL
Piney Green	NC
Pinole	CA
Piqua	OH
Pittsburg	CA
Pittsburg	KS
Pittsburgh	PA
Pittsfield	MA
Placentia	CA
Plainfield	IL
Plainfield	IN
Plainfield	NJ
Plainview	NY
Plainview	TX
Plano	TX
Plant City	FL
Plantation	FL
Plattsburgh	NY
Pleasant Grove	UT
Pleasant Hill	CA
Pleasant Prairie	WI
Pleasanton	CA
Pleasantville	NJ
Pleasure Ridge Park	KY
Plover	WI
Plum	PA
Plymouth	MN
Plymouth Township	MI
Pocatello	ID
Poinciana	FL
Point Pleasant	NJ
Pomona	CA
Pompano Beach	FL
Pompton Lakes	NJ
Ponca City	OK
Pontiac	IL
Pontiac	MI
Poplar Bluff	MO
Poquoson	VA
Port Angeles	WA
Port Arthur	TX
Port Charlotte	FL
Port Chester	NY
Port Hueneme	CA
Port Huron	MI
Port Lavaca	TX
Port Neches	TX
Port Orange	FL
Port Salerno	FL
Port St. John	FL
Port St. Lucie	FL
Port Washington	NY
Port Washington	WI
Portage	IN
Portage	MI
Portales	NM
Porterville	CA
Portland	ME
Portland	OR
Portland	TX
Portsmouth	NH
Portsmouth	OH
Portsmouth	VA
Post Falls	ID
Potomac	MD
Pottstown	PA
Pottsville	PA
Poughkeepsie	NY
Poway	CA
Powder Springs	GA
Prairie Ridge	WA
Prairie Village	KS
Prattville	AL
Prescott	AZ
Prescott Valley	AZ
Prichard	AL
Princeton	FL
Princeton	NJ
Princeton Meadows	NJ
Prior Lake	MN
Prospect Heights	IL
Providence	RI
Provo	UT
Prunedale	CA
Pueblo	CO
Pueblo West	CO
Pullman	WA
Punta Gorda	FL
Puyallup	WA
Quincy	IL
Quincy	MA
Raceland	LA
Racine	WI
Radcliff	KY
Radford	VA
Radnor Township	PA
Rahway	NJ
Raleigh	NC
Ramona	CA
Ramsey	MN
Ramsey	NJ
Rancho Cordova	CA
Rancho Cucamonga	CA
Rancho Mirage	CA
Rancho Palos Verdes	CA
Rancho San Diego	CA
Rancho Santa Margarita	CA
Randallstown	MD
Randolph	MA
Rantoul	IL
Rapid City	SD
Ravenna	OH
Raymore	MO
Raytown	MO
Reading	MA
Reading	OH
Reading	PA
Red Bank	NJ
Red Bank	TN
Red Bluff	CA
Red Hill	SC
Red Wing	MN
Redan	GA
Redding	CA
Redford	MI
Redland	MD
Redlands	CA
Redmond	OR
Redmond	WA
Redondo Beach	CA
Redwood City	CA
Reedley	CA
Reidsville	NC
Reisterstown	MD
Reno	NV
Renton	WA
Reston	VA
Revere	MA
Rexburg	ID
Reynoldsburg	OH
Rialto	CA
Richardson	TX
Richfield	MN
Richland	WA
Richmond	CA
Richmond	IN
Richmond	KY
Richmond	TX
Richmond	VA
Richmond Heights	OH
Richmond West	FL
Richton Park	IL
Ridge	NY
Ridgecrest	CA
Ridgefield	NJ
Ridgefield Park	NJ
Ridgeland	MS
Ridgewood	NJ
Ringwood	NJ
Rio Grande City	TX
Rio Linda	CA
Rio Rancho	NM
Ripon	CA
River Edge	NJ
River Falls	WI
River Forest	IL
River Grove	IL
River Ridge	LA
Riverbank	CA
Riverdale	GA
Riverdale	IL
Riverhead	NY
Riverside	CA
Riverside	OH
Riverton	UT
Riverton-Boulevard Park	WA
Riverview	FL
Riverview	MI
Riviera Beach	FL
Riviera Beach	MD
Roanoke	VA
Roanoke Rapids	NC
Robbinsdale	MN
Robinson Township	PA
Robstown	TX
Rochester	MI
Rochester	MN
Rochester	NH
Rochester	NY
Rochester Hills	MI
Rock Hill	SC
Rock Island	IL
Rock Springs	WY
Rockford	IL
Rockledge	FL
Rocklin	CA
Rockville	MD
Rockville Centre	NY
Rockwall	TX
Rocky Mount	NC
Rocky Point	NY
Rocky River	OH
Rogers	AR
Rohnert Park	CA
Rolla	MO
Rolling Meadows	IL
Rome	GA
Rome	NY
Romeoville	IL
Romulus	MI
Ronkonkoma	NY
Roosevelt	NY
Rosamond	CA
Rosaryville	MD
Rose Hill	VA
Roseburg	OR
Rosedale	MD
Roselle	IL
Roselle	NJ
Roselle Park	NJ
Rosemead	CA
Rosemont	CA
Rosemount	MN
Rosenberg	TX
Roseville	CA
Roseville	MI
Roseville	MN
Ross Township	PA
Rossmoor	CA
Rossville	MD
Roswell	GA
Roswell	NM
Rotterdam	NY
Round Lake Beach	IL
Round Rock	TX
Rowland Heights	CA
Rowlett	TX
Roy	UT
Royal Oak	MI
Royal Palm Beach	FL
Rubidoux	CA
Russellville	AR
Ruston	LA
Rutherford	NJ
Rutland	VT
Rye	NY
Saco	ME
Sacramento	CA
Saddle Brook	NJ
Safety Harbor	FL
Saginaw	MI
Saginaw	TX
Saginaw Township North	MI
Saginaw Township South	MI
Saks	AL
Salem	MA
Salem	OH
Salem	OR
Salem	VA
Salida	CA
Salina	KS
Salinas	CA
Salisbury	MD
Salisbury	NC
Salisbury	NY
Salmon Creek	WA
Salt Lake City	UT
Sammamish	WA
San Angelo	TX
San Anselmo	CA
San Antonio	TX
San Benito	TX
San Bernardino	CA
San Bruno	CA
San Buenaventura (Ventura)	CA
San Carlos	CA
San Carlos Park	FL
San Clemente	CA
San Diego	CA
San Dimas	CA
San Elizario	TX
San Fernando	CA
San Francisco	CA
San Gabriel	CA
San Jacinto	CA
San Jose	CA
San Juan	TX
San Juan Capistrano	CA
San Leandro	CA
San Lorenzo	CA
San Luis	AZ
San Luis Obispo	CA
San Marcos	CA
San Marcos	TX
San Marino	CA
San Mateo	CA
San Pablo	CA
San Rafael	CA
San Ramon	CA
Sand Springs	OK
Sandalfoot Cove	FL
Sandusky	OH
Sandy	UT
Sandy Springs	GA
Sanford	FL
Sanford	ME
Sanford	NC
Sanger	CA
Santa Ana	CA
Santa Barbara	CA
Santa Clara	CA
Santa Clarita	CA
Santa Cruz	CA
Santa Fe	NM
Santa Fe Springs	CA
Santa Maria	CA
Santa Monica	CA
Santa Paula	CA
Santa Rosa	CA
Santee	CA
Sapulpa	OK
Saraland	AL
Sarasota	FL
Sarasota Springs	FL
Saratoga	CA
Saratoga Springs	NY
Saugus	MA
Sauk Rapids	MN
Sauk Village	IL
Sault Ste. Marie	MI
Savage	MN
Savage-Guilford	MD
Savannah	GA
Sayreville	NJ
Sayville	NY
Scarsdale	NY
Schaumburg	IL
Schenectady	NY
Schererville	IN
Schertz	TX
Schiller Park	IL
Schofield Barracks	HI
Scotch Plains	NJ
Scott Lake	FL
Scott Township	PA
Scotts Valley	CA
Scottsbluff	NE
Scottsboro	AL
Scottsdale	AZ
Scranton	PA
Seaford	NY
Seagoville	TX
Seal Beach	CA
Searcy	AR
Seaside	CA
SeaTac	WA
Seattle	WA
Seattle Hill-Silver Firs	WA
Sebastian	FL
Secaucus	NJ
Security-Widefield	CO
Sedalia	MO
Sedona	AZ
Seguin	TX
Selden	NY
Selma	AL
Selma	CA
Seminole	FL
Setauket-East Setauket	NY
Seven Hills	OH
Seven Oaks	SC
Severn	MD
Severna Park	MD
Sevierville	TN
Seymour	IN
Shafter	CA
Shaker Heights	OH
Shakopee	MN
Shaler Township	PA
Sharon	PA
Sharonville	OH
Shawnee	KS
Shawnee	OK
Sheboygan	WI
Shelby	MI
Shelby	NC
Shelbyville	IN
Shelbyville	KY
Shelbyville	TN
Shelton	CT
Shenandoah	LA
Sheridan	WY
Sherman	TX
Sherrelwood	CO
Sherwood	AR
Sherwood	OR
Shiloh	OH
Shiloh	PA
Shirley	NY
Shively	KY
Shoreline	WA
Shoreview	MN
Shorewood	WI
Shreveport	LA
Sidney	OH
Sierra Madre	CA
Sierra Vista	AZ
Sierra Vista Southeast	AZ
Sikeston	MO
Siloam Springs	AR
Silver City	NM
Silver Spring	MD
Silverdale	WA
Simi Valley	CA
Simpsonville	SC
Sioux City	IA
Sioux Falls	SD
Skokie	IL
Slidell	LA
Smithfield	NC
Smiths	AL
Smithtown	NY
Smyrna	GA
Smyrna	TN
Snellville	GA
Snyder	TX
Socastee	SC
Socorro	TX
Soddy-Daisy	TN
Solana Beach	CA
Soledad	CA
Solon	OH
Somers Point	NJ
Somerset	KY
Somerset	MA
Somerset	NJ
Somersworth	NH
Somerville	MA
Somerville	NJ
South Bend	IN
South Bradenton	FL
South Burlington	VT
South Charleston	WV
South Daytona	FL
South El Monte	CA
South Elgin	IL
South Euclid	OH
South Farmingdale	NY
South Gate	CA
South Gate	MD
South Hill	WA
South Holland	IL
South Houston	TX
South Jordan	UT
South Lake Tahoe	CA
South Laurel	MD
South Lyon	MI
South Miami	FL
South Miami Heights	FL
South Milwaukee	WI
South Ogden	UT
South Orange	NJ
South Park Township	PA
South Pasadena	CA
South Plainfield	NJ
South Portland	ME
South River	NJ
South Salt Lake	UT
South San Francisco	CA
South San Jose Hills	CA
South Sioux City	NE
South St. Paul	MN
South Valley	NM
South Venice	FL
South Whittier	CA
South Yarmouth	MA
South Yuba City	CA
Southaven	MS
Southbridge	MA
Southern Pines	NC
Southfield	MI
Southgate	MI
Southglenn	CO
Southlake	TX
Spanaway	WA
Spanish Fork	UT
Spanish Lake	MO
Sparks	NV
Spartanburg	SC
Speedway	IN
Spencer	IA
Spokane	WA
Spring	TX
Spring Creek	NV
Spring Hill	FL
Spring Valley	CA
Spring Valley	NV
Spring Valley	NY
Springboro	OH
Springdale	AR
Springdale	NJ
Springdale	OH
Springfield	IL
Springfield	MA
Springfield	MO
Springfield	NJ
Springfield	OH
Springfield	OR
Springfield	PA
Springfield	TN
Springfield	VA
Springville	UT
St. Albans	WV
St. Andrews	SC
St. Ann	MO
St. Augustine	FL
St. Charles	IL
St. Charles	MD
St. Charles	MO
St. Clair Shores	MI
St. Cloud	FL
St. Cloud	MN
St. George	UT
St. Helens	OR
St. James	NY
St. Joseph	MO
St. Louis	MO
St. Louis Park	MN
St. Marys	GA
St. Marys	PA
St. Matthews	KY
St. Paul	MN
St. Peters	MO
St. Petersburg	FL
St. Simons	GA
Stafford	TX
Stamford	CT
Stanford	CA
Stanton	CA
Starkville	MS
State College	PA
Statesboro	GA
Statesville	NC
Staunton	VA
Stephenville	TX
Sterling	CO
Sterling	IL
Sterling Heights	MI
Steubenville	OH
Stevens Point	WI
Stillwater	MN
Stillwater	OK
Stockton	CA
Stoneham	MA
Stony Brook	NY
Stony Point	NY
Storm Lake	IA
Storrs	CT
Stoughton	WI
Stow	OH
Stratford	CT
Streamwood	IL
Streator	IL
Streetsboro	OH
Strongsville	OH
Struthers	OH
Stuart	FL
Sturgis	MI
Succasunna-Kenvil	NJ
Suffern	NY
Suffolk	VA
Sugar Hill	GA
Sugar Land	TX
Suisun City	CA
Suitland-Silver Hill	MD
Sulphur	LA
Sulphur Springs	TX
Summerville	SC
Summit	IL
Summit	NJ
Sumter	SC
Sun City	AZ
Sun City	CA
Sun City West	AZ
Sun Lakes	AZ
Sun Prairie	WI
Sun Valley	NV
Sunbury	PA
Sunland Park	NM
Sunny Isles Beach	FL
Sunnyside	WA
Sunnyvale	CA
Sunrise	FL
Sunrise Manor	NV
Sunset	FL
Superior	WI
Surprise	AZ
Susanville	CA
Swampscott	MA
Swansea	IL
Sweetwater	FL
Sweetwater	TX
Sycamore	IL
Sylacauga	AL
Sylvania	OH
Syosset	NY
Syracuse	NY
Tacoma	WA
Tahlequah	OK
Takoma Park	MD
Talladega	AL
Tallahassee	FL
Tallmadge	OH
Tamalpais-Homestead Valley	CA
Tamarac	FL
Tamiami	FL
Tampa	FL
Tanque Verde	AZ
Tarboro	NC
Tarpon Springs	FL
Tarrytown	NY
Taunton	MA
Taylor	MI
Taylor	TX
Taylors	SC
Taylorsville	UT
Taylorville	IL
Teaneck	NJ
Teays Valley	WV
Tehachapi	CA
Temecula	CA
Tempe	AZ
Temple	TX
Temple City	CA
Temple Terrace	FL
Tenafly	NJ
Terre Haute	IN
Terrell	TX
Terrytown	LA
Terryville	NY
Texarkana	AR
Texarkana	TX
Texas City	TX
The Colony	TX
The Crossings	FL
The Hammocks	FL
The Village	OK
The Woodlands	TX
Thibodaux	LA
Thomasville	GA
Thomasville	NC
Thornton	CO
Thousand Oaks	CA
Tiffin	OH
Tifton	GA
Tigard	OR
Tillmans Corner	AL
Timberlake	VA
Timberlane	LA
Tinley Park	IL
Tinton Falls	NJ
Titusville	FL
Toledo	OH
Toms River	NJ
Tonawanda	NY
Tonawanda	NY
Tooele	UT
Topeka	KS
Torrance	CA
Torrington	CT
Town and Country	MO
Town 'n' Country	FL
Towson	MD
Tracy	CA
Traverse City	MI
Trenton	MI
Trenton	NJ
Trotwood	OH
Troutdale	OR
Troy	AL
Troy	MI
Troy	NY
Troy	OH
Truckee	CA
Trumbull	CT
Trussville	AL
Tualatin	OR
Tuckahoe	VA
Tucker	GA
Tucson	AZ
Tukwila	WA
Tulare	CA
Tullahoma	TN
Tulsa	OK
Tumwater	WA
Tupelo	MS
Turlock	CA
Tuscaloosa	AL
Tuskegee	AL
Tustin	CA
Tustin Foothills	CA
Twentynine Palms	CA
Twin Falls	ID
Twinsburg	OH
Two Rivers	WI
Tyler	TX
Tysons Corner	VA
Ukiah	CA
Union	NJ
Union City	CA
Union City	GA
Union City	NJ
Union City	TN
Union Hill-Novelty Hill	WA
Union Park	FL
Uniondale	NY
Uniontown	PA
Universal City	TX
University	FL
University City	MO
University Heights	OH
University Park	FL
University Park	TX
University Place	WA
Upland	CA
Upper Arlington	OH
Upper Grand Lagoon	FL
Upper Providence Township	PA
Upper St. Clair	PA
Urbana	IL
Urbana	OH
Urbandale	IA
Utica	NY
Uvalde	TX
Vacaville	CA
Vadnais Heights	MN
Valdosta	GA
Valinda	CA
Valle Vista	CA
Vallejo	CA
Valley Falls	RI
Valley Station	KY
Valley Stream	NY
Valparaiso	IN
Van Buren	AR
Van Wert	OH
Vancouver	WA
Vandalia	OH
Vashon	WA
Venice	FL
Ventnor City	NJ
Vermilion	OH
Vernon	TX
Vernon Hills	IL
Vero Beach	FL
Vero Beach South	FL
Verona	NJ
Vestavia Hills	AL
Vicksburg	MS
Victoria	TX
Victorville	CA
Vidalia	GA
Vidor	TX
Vienna	VA
Vienna	WV
View Park-Windsor Hills	CA
Villa Park	IL
Villas	FL
Vincennes	IN
Vincent	CA
Vineland	NJ
Vineyard	CA
Virginia Beach	VA
Visalia	CA
Vista	CA
Wabash	IN
Waco	TX
Wade Hampton	SC
Wadsworth	OH
Wahiawa	HI
Waianae	HI
Wailuku	HI
Waimalu	HI
Waipahu	HI
Waipio	HI
Wake Forest	NC
Wakefield	MA
Waldorf	MD
Walker	MI
Walker Mill	MD
Walla Walla	WA
Wallingford Center	CT
Wallington	NJ
Walnut	CA
Walnut Creek	CA
Walnut Park	CA
Waltham	MA
Wanaque	NJ
Wantagh	NY
Warner Robins	GA
Warren	MI
Warren	OH
Warren	PA
Warrensburg	MO
Warrensville Heights	OH
Warrenville	IL
Warrington	FL
Warsaw	IN
Warwick	RI
Wasco	CA
Washington	DC
Washington	IL
Washington	IN
Washington	MO
Washington	OH
Washington	PA
Watauga	TX
Waterbury	CT
Waterford	MI
Waterloo	IA
Watertown	MA
Watertown	NY
Watertown	SD
Watertown	WI
Waterville	ME
Watervliet	NY
Watsonville	CA
Waukegan	IL
Waukesha	WI
Waupun	WI
Wausau	WI
Wauwatosa	WI
Waverly	MI
Waxahachie	TX
Waycross	GA
Wayne	MI
Wayne	NJ
Waynesboro	VA
Weatherford	TX
Webster	MA
Webster Groves	MO
Weigelstown	PA
Weirton	WV
Wekiwa Springs	FL
Welby	CO
Wellesley	MA
Wellington	FL
Wells Branch	TX
Wenatchee	WA
Weslaco	TX
West Allis	WI
West and East Lealman	FL
West Babylon	NY
West Bend	WI
West Bloomfield Township	MI
West Caldwell	NJ
West Carrollton City	OH
West Carson	CA
West Chester	PA
West Chicago	IL
West Columbia	SC
West Covina	CA
West Des Moines	IA
West Fargo	ND
West Freehold	NJ
West Hartford	CT
West Haven	CT
West Haverstraw	NY
West Hempstead	NY
West Hollywood	CA
West Islip	NY
West Jordan	UT
West Lafayette	IN
West Lake Stevens	WA
West Linn	OR
West Little River	FL
West Memphis	AR
West Mifflin	PA
West Milford	NJ
West Monroe	LA
West New York	NJ
West Norriton	PA
West Odessa	TX
West Orange	NJ
West Palm Beach	FL
West Paterson	NJ
West Pensacola	FL
West Plains	MO
West Point	MS
West Puente Valley	CA
West Sacramento	CA
West Seneca	NY
West Springfield	MA
West Springfield	VA
West St. Paul	MN
West University Place	TX
West Valley	WA
West Valley City	UT
West Warwick	RI
West Whittier-Los Nietos	CA
Westbrook	ME
Westbury	NY
Westchase	FL
Westchester	FL
Westchester	IL
Westerly	RI
Western Springs	IL
Westerville	OH
Westfield	MA
Westfield	NJ
Westlake	OH
Westland	MI
Westminster	CA
Westminster	CO
Westminster	MD
Westmont	CA
Westmont	IL
Weston	FL
Weston	WI
Westport	CT
Westwego	LA
Westwood	NJ
Westwood Lakes	FL
Wethersfield	CT
Weymouth	MA
Wheat Ridge	CO
Wheaton	IL
Wheaton-Glenmont	MD
Wheeling	IL
Wheeling	WV
White Bear Lake	MN
White Center	WA
White Oak	MD
White Oak	OH
White Plains	NY
White Settlement	TX
Whitefish Bay	WI
Whitehall	OH
Whitehall	PA
Whitewater	WI
Whitney	NV
Whittier	CA
Wichita	KS
Wichita Falls	TX
Wickliffe	OH
Wildomar	CA
Wildwood	MO
Wilkes-Barre	PA
Wilkinsburg	PA
Williamsburg	VA
Williamsport	PA
Williamstown	NJ
Willimantic	CT
Williston	ND
Willmar	MN
Willoughby	OH
Willow Grove	PA
Willowbrook	CA
Willowick	OH
Wilmette	IL
Wilmington	DE
Wilmington	MA
Wilmington	NC
Wilmington	OH
Wilmington Island	GA
Wilson	NC
Wilsonville	OR
Wilton Manors	FL
Winchester	KY
Winchester	MA
Winchester	NV
Winchester	VA
Winder	GA
Windsor	CA
Windsor Locks	CT
Winfield	KS
Winnetka	IL
Winona	MN
Winston-Salem	NC
Winter Garden	FL
Winter Gardens	CA
Winter Haven	FL
Winter Park	FL
Winter Springs	FL
Winthrop	MA
Wisconsin Rapids	WI
Wixom	MI
Woburn	MA
Wolf Trap	VA
Wood Dale	IL
Wood River	IL
Woodbridge	NJ
Woodbridge	VA
Woodburn	OR
Woodbury	MN
Woodbury	NJ
Woodhaven	MI
Woodland	CA
Woodlawn	MD
Woodlyn	PA
Woodmere	LA
Woodmere	NY
Woodridge	IL
Woodstock	GA
Woodstock	IL
Woodward	OK
Woonsocket	RI
Wooster	OH
Worcester	MA
Worth	IL
Worthington	MN
Worthington	OH
Wright	FL
Wyandanch	NY
Wyandotte	MI
Wyckoff	NJ
Wylie	TX
Wyoming	MI
Xenia	OH
Yakima	WA
Yankton	SD
Yazoo City	MS
Yeadon	PA
Yeehaw Junction	FL
Yonkers	NY
Yorba Linda	CA
York	PA
Youngstown	OH
Ypsilanti	MI
Yuba City	CA
Yucaipa	CA
Yucca Valley	CA
Yukon	OK
Yuma	AZ
Zachary	LA
Zanesville	OH
Zephyrhills	FL
Zion	IL